DictyosteliumDiscoideum	Amoebozoa	
DictyosteliumPurpureum	Amoebozoa	
EntamoebaHistolytica	Amoebozoa	
EntamoebaDispar	Amoebozoa	
EntamoebaInvadens	Amoebozoa	
GiardiaLamblia	Excavate	Diplomonad
LeishmaniaMajor	Excavate	Euglenozoa
LeishmaniaBraziliensis	Excavate	Euglenozoa
TrypanosomaCruzi	Excavate	Euglenozoa
TrypanozomaBrucei	Excavate	Euglenozoa
NaegleriaGruberi	Excavate	Heterolobosea
TrichomonasVaginalis	Excavate	Parabasilidea
MonosigaBrevicollis	Opisthokonta	Choanoflagellida
AlternariaBrassicola	Opisthokonta	Ascomycota
CandidaAlbicans	Opisthokonta	Ascomycota
CochliobolusHeterostrophus	Opisthokonta	Ascomycota
MycosphaerellaFijiensis	Opisthokonta	Ascomycota
MycosphaerellaGraminicola	Opisthokonta	Ascomycota
NectriaHaematococca	Opisthokonta	Ascomycota
PichiaStipitis	Opisthokonta	Ascomycota
SaccharomycesCerevisiae	Opisthokonta	Ascomycota
SchizosaccharomycesPombe	Opisthokonta	Ascomycota
TrichodermaAtroviride	Opisthokonta	Ascomycota
TrichodermaReesei	Opisthokonta	Ascomycota
TrichodermaVirens	Opisthokonta	Ascomycota
AspergillusCarbonarius	Opisthokonta	Ascomycota
AspergillusNiger	Opisthokonta	Ascomycota
ChaetomiumGlobosum	Opisthokonta	Ascomycota
CryphonectriaParasitica	Opisthokonta	Ascomycota
StagonosporaNodorum	Opisthokonta	Ascomycota
CoprinopsisCinerea	Opisthokonta	Basidiomycota
PucciniaGraminis	Opisthokonta	Basidiomycota
CryptococcusNeoformans	Opisthokonta	Basidiomycota
LaccariaBicolor	Opisthokonta	Basidiomycota
PostiaPlacenta	Opisthokonta	Basidiomycota
BatrachochytriumDendrobatidis	Opisthokonta	Fungi
PhanerochaeteChrysosporium	Opisthokonta	Fungi
SporobolomycesRoseus	Opisthokonta	Fungi
PhycomycesBlakesleeanus	Opisthokonta	Fungi?
EncephalitozoonCuniculi	Opisthokonta	Microporidia
EncephalitozoonIntestinalis	Opisthokonta	Microporidia
EnterocytozoonBieneusi	Opisthokonta	Microporidia
TrichoplaxAdhaerens	Opisthokonta	Metazoa/Placozoa
NematostellaVectensis	Opisthokonta	Eumetazoa/Cnidaria
Celegans	Opisthokonta	Pseudocoelomata/Nematode
BrugiaMalayi	Opisthokonta	Pseudocoelomata/Nematode
SchistosomaMansoni	Opisthokonta	Acoelomata/Flatworm
Capitella	Opisthokonta	Coelomata/Protostomia/Annelida
HelobdellaRobusta	Opisthokonta	Coelomata/Protostomia/Annelida
LottiaGigantea	Opisthokonta	Coelomata/Protostomia/Mollusca
ApisMellifera	Opisthokonta	Coelomata/Protostomia/Arthropoda
DaphniaPulex	Opisthokonta	Coelomata/Protostomia/Arthropoda
AedesAegypti	Opisthokonta	Coelomata/Protostomia/Arthropoda
CulexPipiens	Opisthokonta	Coelomata/Protostomia/Arthropoda
DrosophilaMelanogaster	Opisthokonta	Coelomata/Protostomia/Arthropoda
DrosophilaPseudoobscura	Opisthokonta	Coelomata/Protostomia/Arthropoda
BranchiostomaFloridae	Opisthokonta	Coelomata/Deuterostomia/Chordata
CionaIntestinalis	Opisthokonta	Coelomata/Deuterostomia/Chordata
XenopusTropicalis	Opisthokonta	Coelomata/Deuterostomia/Chordata
TakifuguRubripes	Opisthokonta	Coelomata/Deuterostomia/Chordata
CryptosporidiumHominis	Chromalveolate	Apicomplexan
CryptosporidiumMuris	Chromalveolate	Apicomplexan
CryptosporidiumParvum	Chromalveolate	Apicomplexan
NeosporaCaninum	Chromalveolate	Apicomplexan
PlasmodiumBerghei	Chromalveolate	Apicomplexan
PlasmodiumChabaudi	Chromalveolate	Apicomplexan
PlasmodiumFalciparum	Chromalveolate	Apicomplexan
PlasmodiumKnowlesi	Chromalveolate	Apicomplexan
PlasmodiumVivax	Chromalveolate	Apicomplexan
PlasmodiumYoelii	Chromalveolate	Apicomplexan
TheileriaAnnulata	Chromalveolate	Apicomplexan
TheileriaParva	Chromalveolate	Apicomplexan
ToxoplasmaGondii	Chromalveolate	Apicomplexan
ParameciumTetraurelia	Chromalveolate	Ciliate
TetrahymenaThermophila	Chromalveolate	Ciliate
PerkinsusMarinus	Chromalveolate	Dinoflagellate
FragilariopsisCylindrus	Chromalveolate	Stramenopile
EmilianiaHuxleyi	Chromalveolate	Stramenopile
PhaeodactylumTricornutum	Chromalveolate	Stramenopile
AureococcusAnophagefferens	Chromalveolate	Stramenopiles
PhytophthoraRamorum	Chromalveolate	Stramenopiles
PhytophthoraSojae	Chromalveolate	Stramenopiles
ThalassiosiraPseudonana	Chromalveolate	Stramenopiles
CyanidioschyzonMerolae	Plantae	Rhodophyta
ChlamydomonasReinhardtii	Plantae	Chlorophyta
Chlorella	Plantae	Chlorophyta
MicromonasPusillaCCMP	Plantae	Chlorophyta
MicromonasPusillaRCC299	Plantae	Chlorophyta
OstreococcusRCC809	Plantae	Chlorophyta
OstreococcusLucimarinus	Plantae	Chlorophyta
VolvoxCarteri	Plantae	Chlorophyta
Coccomyxa	Plantae	Chlorophyta
ArabidopsisThaliana	Plantae	Streptophyta
ArabdopsisLyrata	Plantae	Streptophyta
OryzaSativa	Plantae	Streptophyta
PhyscomitrellaPatens	Plantae	Streptophyta
PopulusTrichocarpa	Plantae	Streptophyta
SelaginellaMoellendorffii	Plantae	Streptophyta
SorghumBicolor	Plantae	Streptophyta
BrachypodiumDistachyon	Plantae	Streptophyta
ManihotEsculenta	Plantae	Streptophyta
MimulusGuttatus	Plantae	Streptophyta
